# Level 1 terrain and enemy information

# Terrain Layer
# 0: unbuildable  1: grass  2: high ground  3: low ground
0 0 0 0 0 0 0 0 0 0 0 0 0 0 0 1 1 1 1 1
0 0 0 1 1 1 1 1 0 0 0 0 0 0 0 1 1 1 1 1
0 0 1 1 1 1 1 1 1 1 1 0 0 0 0 1 1 1 1 1
0 0 1 1 1 1 1 1 1 1 1 0 0 0 1 1 1 1 1 1
0 0 1 1 1 1 1 1 1 1 1 1 1 1 1 1 1 1 1 1
0 1 1 1 1 1 1 1 1 1 1 1 1 1 1 1 1 1 1 1
1 1 1 1 0 0 1 0 1 0 0 0 1 0 1 0 0 0 0 1
1 1 1 1 0 0 0 0 0 0 0 0 0 0 0 0 0 0 0 0
1 1 1 0 0 0 0 0 0 0 0 0 0 0 0 0 0 0 0 0
1 1 0 0 0 0 1 0 1 0 2 0 0 0 0 0 0 0 0 0
1 1 1 0 0 0 0 0 0 0 0 0 0 0 0 0 0 0 0 0
1 1 1 1 0 0 0 0 0 0 0 0 0 0 0 0 0 0 0 0
1 1 1 1 0 0 0 0 0 0 0 0 1 0 1 0 0 0 0 1
0 1 1 1 1 1 1 1 1 1 1 1 1 1 1 1 1 1 1 1
0 1 1 1 1 1 1 1 1 1 1 1 1 1 2 2 2 1 1 1
0 0 0 0 0 0 0 0 0 0 1 1 1 1 2 0 2 1 1 1
0 0 0 0 0 0 0 0 0 0 0 1 1 1 2 2 2 1 1 1
3 3 0 0 0 0 0 0 0 0 0 0 1 1 1 1 1 1 1 0
3 3 3 3 0 0 0 0 0 0 0 0 1 1 1 1 1 1 1 0
3 3 3 3 3 3 3 0 0 0 0 0 0 0 0 0 0 0 0 0

# Path Layer
# 0: blank  1: path  2: beaten path	 3: entrance  4: village
0 0 0 0 0 0 0 0 0 0 0 0 0 0 0 0 0 0 0 0
0 0 0 0 0 0 0 0 0 0 0 0 0 0 0 0 0 0 0 0
0 0 0 0 0 0 0 0 0 0 0 0 0 0 0 0 0 0 0 0
0 0 0 0 0 0 0 0 0 0 0 0 0 0 0 0 0 0 4 0
0 0 0 0 0 0 0 0 0 0 0 0 0 0 0 0 0 1 1 0
0 0 0 1 1 1 1 1 1 1 1 1 1 1 1 1 1 1 0 0
0 0 1 1 0 0 0 2 0 0 0 0 0 2 0 0 0 0 0 0
0 1 1 0 0 0 0 2 0 0 0 0 0 2 0 0 0 0 0 0
0 1 0 0 0 0 0 2 0 0 0 0 0 2 0 0 0 0 0 0
0 1 0 0 0 0 0 2 0 0 0 0 0 2 0 0 0 0 0 0
0 1 0 0 0 0 0 2 0 0 0 0 0 2 0 0 0 0 0 0
0 1 1 0 0 0 0 2 0 0 0 0 0 2 0 0 0 0 0 0
0 0 1 1 0 0 0 2 0 0 0 0 0 2 0 0 0 0 0 0
0 0 0 1 1 1 1 1 1 1 1 1 1 1 2 2 2 1 1 3
0 0 0 0 0 0 0 0 0 0 0 0 0 1 0 0 0 1 0 0
0 0 0 0 0 0 0 0 0 0 0 0 0 1 0 0 0 1 0 0
0 0 0 0 0 0 0 0 0 0 0 0 0 1 0 0 0 1 0 0
0 0 0 0 0 0 0 0 0 0 0 0 0 1 1 1 1 1 0 0
0 0 0 0 0 0 0 0 0 0 0 0 0 0 0 0 0 0 0 0
0 0 0 0 0 0 0 0 0 0 0 0 0 0 0 0 0 0 0 0

# Resources Layer
# 0: blank  1: trees  2: stones  3: iron
0 0 0 0 0 0 0 0 0 0 0 0 0 0 0 0 0 0 0 0
0 0 0 2 0 2 0 0 0 0 0 0 0 0 0 0 0 0 0 0
0 0 0 0 0 0 0 0 0 0 0 0 0 0 0 2 0 0 0 0
0 0 2 1 1 1 1 1 0 0 0 0 0 0 2 2 0 0 0 1
0 0 0 0 1 1 1 1 1 1 0 0 0 0 0 0 0 0 0 1
0 0 0 0 0 0 0 0 0 0 0 0 0 0 0 0 0 0 0 1
0 0 0 0 0 0 1 0 1 0 0 0 1 0 1 0 0 0 0 1
1 0 0 1 0 0 0 2 0 0 0 0 0 3 0 0 0 0 0 0
1 0 0 0 0 0 0 0 0 0 0 0 0 0 0 0 0 0 0 0
1 0 0 0 3 0 2 0 2 0 0 0 0 3 0 0 0 3 0 0
1 0 0 0 0 0 0 0 0 0 0 0 0 0 0 0 0 0 0 0
1 0 0 1 0 0 0 2 0 0 0 0 0 3 0 0 0 0 0 0
0 1 0 0 0 0 1 0 1 0 0 0 1 0 1 0 0 0 0 1
0 0 1 0 0 0 0 0 0 0 0 0 0 0 0 0 2 0 0 0
0 0 0 1 1 1 1 1 0 0 0 0 2 0 0 0 0 0 2 0
0 0 0 0 0 0 0 0 0 0 0 0 0 0 0 1 0 0 0 0
0 0 0 0 0 0 0 0 0 0 0 0 0 0 0 0 0 0 0 0
2 0 0 0 0 0 0 0 0 0 0 0 0 0 0 0 0 0 0 0
3 0 2 2 0 0 0 0 0 0 0 0 0 0 0 0 0 0 0 0
3 3 0 0 0 2 0 0 0 0 0 0 0 0 0 0 0 0 0 0

# Enemy Information